###########
#.........#
#.........#
#.........#
#.........#
#.........#
#.........#
#.........#
#......@..#
#.........#
###########